[console_scripts]
compassreportstobq = vicedtools.scripts.compassreportstobq:main
compassstudentdetailstobq = vicedtools.scripts.compassstudentdetailstobq:main
compassstudentenrolmenttobq = vicedtools.scripts.compassstudentenrolmenttobq:main
createcompassreportssummaries = vicedtools.scripts.createcompassreportssummaries:main
createcompasssubjectsmetadatacsv = vicedtools.scripts.createcompasssubjectsmetadatacsv:main
createnaplansummary = vicedtools.scripts.createnaplansummary:main
createoarsstudentimports = vicedtools.scripts.createoarsstudentimports:main
createpatparentlettertable = vicedtools.scripts.createpatparentlettertable:main
ewritescorestobq = vicedtools.scripts.ewritescorestobq:main
ewritesittingstoscores = vicedtools.scripts.ewritesittingstoscores:main
exportcompassacademicgroups = vicedtools.scripts.exportcompassacademicgroups:main
exportcompassclasses = vicedtools.scripts.exportcompassclasses:main
exportcompassenrolments = vicedtools.scripts.exportcompassenrolments:main
exportcompasslearningtask = vicedtools.scripts.exportcompasslearningtask:main
exportcompasslearningtasks = vicedtools.scripts.exportcompasslearningtasks:main
exportcompassprogressreport = vicedtools.scripts.exportcompassprogressreport:main
exportcompassprogressreportcycles = vicedtools.scripts.exportcompassprogressreportcycles:main
exportcompassprogressreports = vicedtools.scripts.exportcompassprogressreports:main
exportcompassreport = vicedtools.scripts.exportcompassreport:main
exportcompassreportcycles = vicedtools.scripts.exportcompassreportcycles:main
exportcompassreports = vicedtools.scripts.exportcompassreports:main
exportcompasssds = vicedtools.scripts.exportcompasssds:main
exportcompassstudenthouseholdinformation = vicedtools.scripts.exportcompassstudenthouseholdinformation:main
exportcompassstudents = vicedtools.scripts.exportcompassstudents:main
exportcompasssubjectmetadata = vicedtools.scripts.exportcompasssubjectmetadata:main
exportnaplanoutcomes = vicedtools.scripts.exportnaplanoutcomes:main
exportnaplansssr = vicedtools.scripts.exportnaplansssr:main
exportoarsmetadata = vicedtools.scripts.exportoarsmetadata:main
exportoarssittings = vicedtools.scripts.exportoarssittings:main
exportoarsstaff = vicedtools.scripts.exportoarsstaff:main
exportoarsstudents = vicedtools.scripts.exportoarsstudents:main
exportvassexternalscores = vicedtools.scripts.exportvassexternalscores:main
exportvassgatscores = vicedtools.scripts.exportvassgatscores:main
exportvassmoderatedscores = vicedtools.scripts.exportvassmoderatedscores:main
exportvasspredictedscores = vicedtools.scripts.exportvasspredictedscores:main
exportvassschoolprogram = vicedtools.scripts.exportvassschoolprogram:main
exportvassschoolscores = vicedtools.scripts.exportvassschoolscores:main
exportvassstudentdetails = vicedtools.scripts.exportvassstudentdetails:main
naplanoutcomestobq = vicedtools.scripts.naplanoutcomestobq:main
patmostrecentobq = vicedtools.scripts.patmostrecentobq:main
patscorestobq = vicedtools.scripts.patscorestobq:main
patscorestomostrecent = vicedtools.scripts.patscorestomostrecent:main
patsittingstoscores = vicedtools.scripts.patsittingstoscores:main
